..###############################################################################
..........#.......................#.#...#...#.#.......#.#...................#...#
#.###########.#.#####.#####.#.#.#.#.#.###.###.#####.#.#.###.#.###.#.#.#####.#.#.#
#.....#...#.#.#...#.....#...#.#.#.....#.#...#.....#.#.#...#.#...#.#.#.#...#...#.#
#.###.#.#.#.#######.#####.#####.#######.###.###.#####.###.###.#####.#####.#.#.#.#
#.#.....#.#.#.....#.#.#...#...#.#...#.#...#.#.......#.............#...#.#.#.#.#.#
#.#.###.#.#.###.#.###.#.#.###.#.###.#.#.###.#.#######.#.#########.###.#.#.#.#.###
#.#.#.#.#.....#.#.......#...#.....#...#...#...#.#...#.#.#...#.......#...#...#.#.#
###.#.#####.#####.#########.#.#.#####.#.#.#.###.#.###.###.###################.#.#
#.......#.#.........#.#.#...#.#.....#...#...#...#.#.........#.#.#.........#.....#
#.#.#.#.#.#######.###.#.#####.###.###.#########.#.#.#####.#.#.#.###.###.###.#####
#.#.#.#.#...#...........#.#.#...#.#.#...#.......#...#.....#.#...#...#...#.#.....#
###.###.###.###.#####.###.#.#.###.#.#.#####.#.#.#.#.###.###.###.###.#####.#####.#
#.....#.....#.#.#.#.......#.#.#...#.#.....#.#.#.#.#.#.#.#.#.....#...#...#.#.#...#
#.#####.#.###.###.#####.###.#####.#.#.#####.###.#.###.#.#.#####.###.#.###.#.#####
#.#...#.#.......#.#.........#.........#...#...#.....#...#.#.......#.............#
#####.#.#.#####.#.#.#.#####.#.###.#######.#.#####.#######.#.###.###.###.#######.#
#.#.....#...#.#...#.#.....#.#.#.#.....#.#.......#...#.#.......#.#...#.#.#.....#.#
#.#####.###.#.#.#######.#.#.###.#.#####.###.#.###.#.#.#####.#######.#.#######.#.#
#...#.....#.#.#.#.....#.#.#...#.#.........#.#...#.#...#.....#...........#...#...#
#.#.#.###.#.#.#.#####.#.#######.#########.#############.###.#.#####.###.#.#######
#.#.#.#...#...#.#...#.....#...........#...#.#.#.........#.....#.#...#.....#.#.#.#
#.#####.#.#####.###.#######.#.#.#.#.#####.#.#.###.###.#.#######.#########.#.#.#.#
#.......#.#.......#.......#.#.#.#.#...#.......#.#.#...#.#.#.#...#.#...#.#.....#.#
#########.#######.#.#########.#####.#.#.#####.#.#.###.###.#.#.#.#.###.#.#####.#.#
#.....#.....#...#.........#.#...#...#.#...#.....#.#...#...#.#.#.#.#.......#...#.#
#.###.###.#####.###.#.###.#.#######.#####.#.#########.#.#.#.###.#.#.#####.###.#.#
#.#.....#...#.......#.#.#.#...#.#.......#.#.........#.#.#...#.#.....#.....#.....#
###.###.#######.#.#####.#.#.#.#.#.#.#.###.#######.#####.#####.#.#.#########.###.#
#.....#.........#.......#.#.#.....#.#.........#.#.#...#.#...#...#.....#.......#.#
#####.#.#.###.#######.#.#############.#######.#.###.###.###.#.#.###.###.###.###.#
#.....#.#.#.#.#.....#.#...#.....#...#...#.......#.....#.......#...#.....#.....#.#
#.###.###.#.###.#.#######.#.#######.#######.#.#####.#####.#####.###.###.#######.#
#.#...#...#...#.#.#.#...#.#.....#.....#...#.#...#...#.#.......#...#.#.#...#.....#
#.#.#.###.###.###.#.#.#######.#.#.#####.###.#####.#.#.#.###.#.#######.###.#######
#.#.#...#...#.#...#...#.#.#...#.....#.....#.#.#...#.....#...#.#.#.........#.....#
#########.#.#.#.#####.#.#.#.###.#.#.#.#.#.###.###########.#####.#####.#####.#.###
#.#.#.#.#.#...............#...#.#.#.#.#.#...#.....#...#.....#.......#.#...#.#.#.#
#.#.#.#.#.#.###.#.#######.#####.#.###.###########.#.###.#.#######.#####.###.###.#
#...#.....#...#.#.#...#.......#.#.......#...#...#.#...#.#.........#.#.#.#.#.#...#
#.#.###.###.###.#.###.#.###.#######.###.#.#.#.###.###.###########.#.#.#.#.#.#.###
#.#.#.....#...#.#.#.#...#.#.#...#...#.....#.#.#.#.....#.#.........#...#.....#...#
#.#.###.#.###.#.#.#.#####.#.###.###.#######.#.#.#.#####.#.#########.#.#.###.###.#
#.#...#.#...#.#.#.........#.#.......#.....#.......#.#...#.#.........#...#.......#
#####.#.#####.#####.#######.###.#.#.#.#.#####.#####.#.###.#####.#########.###.#.#
#...#.....#.#.#.......#.#...#...#.#...#.....#.#...#.......#...#.#.....#.#...#.#.#
#.#.#.#####.###.#.#.#.#.###.#######.###########.#####.###.#.#####.#####.###.###.#
#.#...#.#...#...#.#.#...#.....#.#...#.........#.#.#.....#.....#.....#...#.#.#.#.#
#####.#.#.###.###.#######.#####.#.#######.#####.#.###.###.#####.#.#####.#.#.#.#.#
#.....#.....#...#...#.......#...#.#...#...#.........#.#...#.#.#.#.........#...#.#
###.#####.#####.#.#########.###.#.###.#.#.#.###.###.###.#.#.#.#.#.###.#.###.#.###
#.#.#...........#...#...............#.#.#...#.#...#...#.#.....#.#.#...#.....#...#
#.#######.#######.#.###.#####.#######.###.###.#.#.###.#####.###############.###.#
#.#...#...#.#.....#...#.#.#...........#.#...#.#.#.#.......#.....#...#.......#...#
#.#.#######.###.###.#####.###.#.###.###.#####.#.#####.#####.###.#.#.#####.###.###
#.#.#.....#.....#.....#...#.#.#...#.......#.#.#.#.....#.#...#...#.#.......#.#.#.#
#.#.#.#################.###.#####.###.###.#.#.#######.#.#.#.###.#.###.#.#.#.###.#
#...#.....#.........#.#...........#...#.........#.........#...#.#.#...#.#.......#
###.#.###.#.#.###.###.#.#.#######.#.#.###.###.#######.#.#.#.###.#.#######.#####.#
#.....#.....#.#.........#.......#.#.#...#.#...........#.#.#...#...#.......#.....
###############################################################################.