..#########
........#.#
#.#.#.###.#
#.#.#.#...#
#.#####.###
#.....#...#
#.###.###.#
#.#.......#
#.#####.###
#.....#...#
#########.#