..#################################################
....#.....#...#...#...#.#.#.........#...#.........#
#.###.###.#.#.#.###.#.#.#.#######.###.#######.###.#
#.....#...#.#.......#.....#.......#...#.#...#...#.#
#######.###.#.#####.###.#######.#####.#.#.###.###.#
#...#.#...#.#...#.#.#.#.#...#.....#.#...........#.#
#.#.#.#.#########.#.#.###.###.###.#.#.#.#########.#
#.#.........#.....#.#.#.........#...#.#.#.#...#...#
#.#######.#.###.#.#.#.#.#####.#.#.###.#.#.#.#.#.#.#
#...#...#.#.#...#.......#...#.#.#.#...#.....#.#.#.#
#.#####.#.###.#.###########.###.###.###.#######.#.#
#...#.........#...#.#.....#...#.......#.....#...#.#
###.###.#.###.#.#.#.###.#####.###.#.#########.#####
#.....#.#.#.#.#.#.#...............#.#.#...#.......#
#####.#####.#.#########.###.###.###.#.#.#.###.###.#
#.#...#.#...#...#.....#.#.....#.#...#...#.#...#...#
#.#.###.###.###.#####.###########.###.#############
#.....#.#.....#.#...#.........#.....#.#.....#.....#
#####.#.#.#.#######.#.#.###.###.#.#.#.###.#.#.#####
#.....#.#.#...#...#...#.#.....#.#.#.#.#...#.......#
#.#####.#.###.###.###.#########.###.#.#.###.###.#.#
#.....#...#...#.....#.....#...#.#...#.#...#...#.#.#
###########.#.#.#########.#.###.###.#.#.#.#########
#...#.#.....#...#.#.#.....#...#.#.......#.........#
###.#.#.###.#####.#.###.#####.###.#.#####.#######.#
#.......#...........#...#.......#.#.#.....#.#.....#
#######.#.#.###.#.###.#.#.#####.#.###.#.###.#.#.#.#
#.....#.#.#...#.#.#.#.#.......#.#.#...#...#...#.#.#
#.###.#.#########.#.#####.###.#########.###.#.###.#
#.#...#...#.......#.#.....#.#.#.....#.....#.#...#.#
#.###.#.###########.#.#.#.#.#.#.#.#.#.#.#.###.###.#
#.#...#...#...........#.#...#...#.#...#.#...#.#...#
#.#.###.#.#.###.###########.#.#.###.#####.#.#####.#
#.#.....#.#.#.#...#.....#...#.#...#.#.....#...#...#
###.#.#######.#########.#########.###.###.#.#####.#
#...#...#...#...#.#.......#.#.#...#.#.#...#...#...#
###.#####.#.#.###.#.###.###.#.#####.###.#.###.#####
#.......#.#...#.....#.#.#.#...#.#.#.....#.#.......#
###.#.#.###.#####.#.#.###.#.#.#.#.###.#.#########.#
#...#.#...........#.........#.........#...#.......
#################################################.