..###########################################################
........#...#.....#...#...#...#...#.......#.#.#...#.......#.#
###.#######.###.#.#.#.###.#.#####.#.#######.#.###.#.#####.#.#
#.#.#.........#.#.#.#.#...#.#.#...#.......#...#.#...#.#.#...#
#.#.#.#.#.#.###.###.#.###.#.#.#.#######.#.###.#.#####.#.###.#
#...#.#.#.#.....#...#.....#.#...........#...........#.......#
###.#####.#####.#####.#.###.#####.#######.###.#######.###.#.#
#.............#.#.#.#.#.......#.......#.#.#.....#...#.#.#.#.#
#.#####.#####.#.#.#.#.###.#.#.#########.#.###.#.###.#.#.#.###
#.#.#.#...#...#.#.....#.#.#.#...#.#.........#.#.#.....#.....#
#.#.#.#####.#####.#####.#####.###.###.###.#.#.#.#.#######.#.#
#.....#.....#.....#.#.#.....#...#...#.#.#.#.#.#.....#.....#.#
#.#####.###.#.###.#.#.#.#######.#.###.#.#####.#.#.#####.#.###
#.#...#.#.......#.....#.....#.#.#.....#.....#.#.#...#...#.#.#
#.###.###.#.#.#.#####.#.#####.#####.###.#.#.###.#.#.###.#.#.#
#...#.#...#.#.#.....#.#.#.....#...#.#.#.#.#...#.#.#.#.#.#...#
###.#.#.###.###.#.###.#.#####.###.###.#.#.###.###.#.#.#.###.#
#...#.....#...#.#.#...........#.........#.#...#...#...#.#...#
#.#.#.###.###.###.#.#####.###.###.###.#.#.#.#.#.#####.###.#.#
#.#.#...#...#.#...#...#.....#.#...#...#.#.#.#.#.#...#...#.#.#
#.###.###################.#.#####.#.#.#.#####.#.#.#####.#.###
#...#.....#...............#.....#.#.#.#.#.#...#.#...#...#...#
#.#######.#.#####.#.###.#.###.#.#.###.###.#########.###.#.#.#
#.#.#.....#...#...#.#...#.#.#.#...#.#...#.#.......#.....#.#.#
#.#.###.###.###.#.#########.#####.#.#.###.###.#.###.#.#####.#
#.#.......#.#...#.....#.#...#.#.....#.....#.#.#...#.#.#.#...#
#####.###.#########.#.#.###.#.#.#.#.#####.#.###.###.###.#.###
#...#...#.......#.#.#.#.........#.#.#.....#.#...........#.#.#
###.#.#######.###.#######.#######.#####.#.#.#.###.#######.#.#
#.........#...........#.......#.....#...#.....#.........#...#
###########################################################.#