..###############################################################################
....#.#.....#.....#.#.....#...#.........#.....#...#.......#...#.............#...#
#.###.#.#.###.###.#.#.#######.#.###.#######.###.#####.#######.#######.#####.###.#
#.....#.#.......#.#.#.#...#.#...#...#.#.#.#.#.#...#.....#.#.....#...#.#.........#
#.###.#####.#####.#.#.#.###.#######.#.#.#.#.#.###.###.#.#.#.#######.#####.#.###.#
#.#...#.#.......#.....#...#.....#...#...#.....#.#...#.#.....#.....#.#...#.#.#...#
#.#.###.#########.#######.#.###.#.#.###.###.#.#.#.###.#######.#####.#.#.#.#####.#
#.#.#...............#...#.#.#.#...#.......#.#.#...#.#...#.#.....#.#.#.#.....#...#
#.#####.#.#.#.###.#.#.#.#.###.###.###.#.#.#.###.###.###.#.###.###.#.#####.#.#####
#.......#.#.#...#.#.#.#...#.#.#...#.#.#.#...#...#.#.............#.....#.#.#.....#
#######.#######.#.###.#.#.#.#.#####.###.#.#.###.#.###.#######.#.###.#.#.#.#####.#
#.#...#.....#.#.#...#.#.#.#...#...#.....#.#.#.......#...#...#.#...#.#.......#.#.#
#.###.#######.#####.#####.#.#####.#####.###.#.#######.#####.#######.#####.###.#.#
#.....#.......#.#.#.....#...........#...#.#.#.#.#.........#.............#.#...#.#
#.#####.#.###.#.#.###.#########.#.###.#.#.#.#.#.#######.#.###.###.###.#######.#.#
#.#.....#...#.........#...#...#.#.....#.#.#.....#.....#.#.......#.#...#.........#
#.#.###.#.#.###.#####.#.#####.#####.#.###.#.###.###.#.#.#######.#.#.###.#########
#.....#.#.#.#...#...#.#...#...#.#...#.#.#.#...#.#.#.#.#.#...#.#.#.#.#.....#.....#
#.#####.#.#.#.###.#.#.#.###.#.#.#.#####.#.#####.#.#.#.#.###.#.#.###.#.#.###.#####
#...#.#.#.#.#...#.#.#.....#.#.......#...............#.#.#.....#.#...#.#.#.......#
#####.#####.###.#.###.#####.###.#.#################.#########.#.#########.#####.#
#.#.#.........#.#...........#...#...#.#...#...#.......#.....#.......#.....#.....#
#.#.#.#.#######.###.###.#######.###.#.#.###.###.#####.#.#.#.###.#.###.###.#.#####
#.....#.#.........#.#.....#.......#...#...#.......#.#.#.#.#.#...#.....#...#.#...#
#######.#######.###.#####.#.#.#.###.###.#####.#####.#.#.###.###.#######.#.#.#.###
#.....#.#.....#.#.#.#.....#.#.#.#.....#.....#.#...#.#...#.#.........#.#.#.#.#...#
#####.#.#####.###.#.#####.#.###########.###.#.#.#.#.#.###.#.#.#######.###.#####.#
#.#.#.....#...#.......#...#.........#...#.#.....#.#.#.#.#...#.....#...#...#...#.#
#.#.#.###.###.#.###.#####.#.###.#####.###.#####.###.#.#.#.#.###.#.###.#.#####.#.#
#.......#.#.......#.....#.#...#.....#.....#.........#...#.#...#.#.....#.........#
###############################################################################.#