..#######################################
....#.....#.#.....#.#.......#.#.......#.#
###.###.###.#.#.###.#.#.#####.#####.#.#.#
#.....#.#.#...#...#...#...#.#.......#.#.#
#.###.#.#.###.#.###.#####.#.#######.#.#.#
#.#.#...#.....#.#...#.........#.#.#.#.#.#
#.#.#.#.###.#.#.#.#.#####.#.###.#.#.###.#
#.#...#...#.#.#...#.#...#.#...#.........#
#.#############.#.#####.#.#####.#########
#.......#...#.#.#...#.........#...#.....#
#######.###.#.#########.###.#.#.#.#.###.#
#.......#.#...#.#.#.....#.#.#.#.#.....#.#
#.#.#.###.###.#.#.#.###.#.#####.#######.#
#.#.#.........#.#.....#.....#.#.#.....#.#
###.#.#.###.###.###.#.###.###.#.###.#.#.#
#...#.#.#.#.......#.#.#.#.#...#...#.#...#
###.#.#.#.#.#####.#.###.#####.#.#.#######
#...#.#.#...#.....#.#.#...#...#.#...#...#
#.#.#####.#.#.#.###.#.###.#.#.#.#####.###
#.#...#...#.#.#.............#...........#
#######################################.#