..###############################################################################
....#...#...........#.#...#.......#...#.....#.....#...#.#.....#...#.......#.....#
#.###.#####.#.#####.#.###.#####.###.#.#.#.###.###.#.###.#.###.#.###.#.#######.#.#
#.#.....#...#...#.......#.#.........#...#.#.#.#...#...#.#...#.#.#.#.#.#.#.....#.#
#.#.#.#.#####.#.#.#######.#.#.#####.#.#####.###.#.#.###.#.#.###.#.#.#.#.#####.###
#...#.#...#...#.#.#.#.#.#.#.#.#.#.#.#.#.....#...#.........#...#...#.#...#.......#
###.#.#.#####.###.#.#.#.#.###.#.#.###.#.###########.###.#####.#.#.#####.###.###.#
#...#.#.......#...#.#.#.......#...#.#.#...#.#...#.#.#.......#...#...#.......#.#.#
#.#####.#####.#.#.#.#.###.#######.#.###.###.#.###.#.#####.#.###.#.###.#######.###
#.....#.#.....#.#.#.........#...#...#.#.#.......#.#...#...#...#.#.#.#...#...#.#.#
#.#########.#####.#.###.#.#.###.#.#.#.#.###.#####.###########.###.#.#.#.#.#.#.#.#
#.#...#...#.#...#.....#.#.#.....#.#.#.........#.............#...#.....#...#...#.#
#.#.###.#######.#######.#####.#####.#.#####.#####.#######.###.#.#.#####.#####.#.#
#.......#.#.#.#.....#.....#.......#.#.#...#.............#.#.#.#.#.....#.....#...#
#######.#.#.#.#.###.#.#####.#.###.#.#.#.#####.#.#.#.###.###.#.#.#####.###.###.#.#
#.......#...#...#...#.#.#.#.#.#.....#.#.#.....#.#.#.#.....#.#.#.#.......#...#.#.#
#.###.#####.###.#.#####.#.###.#.#####.#.###############.#.#.###.###.###########.#
#.#.............#.#.....#...#.#.#...#.#...#.#.....#.#.#.#.#.#.#...#.#.#.#.......#
#.###.#.#.###.#######.#.###.#.#####.#.###.#.#.###.#.#.#.###.#.#######.#.#####.###
#.#...#.#.#...#.......#...#...#.........#...#.#.#.#...#.#.......#.....#.#.#.....#
#.###.###.#######.#####.#.#.#####.###.#####.###.#.#.###.#.###.#####.###.#.#.#.###
#.#...#.#.#.#...#.....#.#...#.....#...#.#.#.#.........#.....#.#...#.........#.#.#
#####.#.#.#.###.#######.###.###.#.#.###.#.#.#.#.###########.###.###.#.###.#.###.#
#...#.#...#...............#.#...#.#.#.......#.#.#.#.#...#.....#.....#.#...#.....#
#.#.###.#.###.#######.#.#.#.###.#.###.#####.###.#.#.#.#.#####.#.#####.###.#.###.#
#.#.#.#.#.#.......#...#.#.#...#.#.#.....#.....#...#...#.....#.#.#.#.....#.#.#.#.#
#.###.#.#####.#.#.###############.#.#.#####.###.#.###.###.###.#.#.###########.#.#
#...#.......#.#.#...#...............#.#.........#.#.....#.#...#.#.......#.#.#...#
###.###.###.#.###.#########.#.#######.###.#####.###.#.###.#####.#.###.###.#.###.#
#...#.#...#.#.#.#.....#...#.#...#.#.#.#.#...#.#.....#...#.#.#.......#.#.#...#.#.#
###.#.###.#####.#.#####.#.###.#.#.#.#.#.#####.#####.###.###.#.#.#######.#.###.#.#
#...#.#...#.#.....#.....#.#.#.#.#.#...#.......#.....#.....#...#.#.....#...#.....#
#.###.#####.#.#.###.###.###.#####.#.#####.#.###.#############.#.#.###.#.#.#####.#
#.....#.....#.#.#...#.#.#.........#.......#...#.#.#.#.#...#.#.#.#.#.....#.#...#.#
#####.###.#####.#.###.#.#.#.#.#######.#.#.###.###.#.#.#.#.#.#.#.#.#.###.###.#####
#...#.......#.#.......#.#.#.#...#.....#.#.#.......#.....#.....#.#.#.#.......#...#
###.#####.###.#####.#.#####.###.#.###.###.###.#.#.#.#.###.#.#.#######.###.###.#.#
#.#.....#.#.....#...#.#...#.#.#.#...#.#.#.#...#.#...#.#.#.#.#.#...#...#.......#.#
#.#.###.#.###.#####.#####.#.#.#.###.###.#.#######.#.###.#####.#.#.#.###.#######.#
#.#...#.#.#.#...#.....#.#.#.#.....#...#.....#.....#...#.......#.#.#...#.....#...#
#.###.#.#.#.#.#####.#.#.#.#.###.###.#########.#.#######.#.#.###.###.###.#.###.###
#...#.#...#.....#...#.......#.....#...#.#.....#...#.#.#.#.#.#.......#...#...#...#
#.###.###.#.#####.#.###.#############.#.###.#.#####.#.###.#######.###########.###
#.......#.....#.#.#...#.............#.#...#.#...#...#.....#.#.#.#.#.#...#.......#
#.###.###.#####.#.###.#################.###########.#.###.#.#.#.#.#.###.###.#####
#.#...#.#.#.......#.#...#.....#.#...#...#.#.#.#...#.#.#...#...#.#.#.#.....#.....#
#.#.###.#.###.#.###.#.###.#.###.#.#####.#.#.#.#.#.#.#.#####.###.#.#.#.#.#.#######
#.#.#...#...#.#...#.#.....#.#.#...#.....#.......#.#.#.....#.#...#.#...#.#.#.....#
#.#.#.#####.#.#####.#.#.###.#.#.###.#.#.#.###.#.###.#####.#.#.###.###.#####.###.#
#.#.#...........#.#...#.#.....#.#...#.#...#...#.....#.....#...#.#.#.#.....#...#.#
#.###.###.#######.###.#######.#.###.#####.#.###.###.#.###.#.#.#.#.#.#.###.#.#####
#.#.#.#...#.......#.......#...#.#.#.#.....#.#.....#.....#.#.#.......#.#...#.....#
###.#.#.#####.#####.#.#.#######.#.#.###.###############.#####.#####.#.#####.#.#.#
#.....#.#.......#...#.#.........#...#...#.#.#.#.....#...#...#.#...#.....#.#.#.#.#
#####.###.#####.#.#.#.#.#.###.###.###.###.#.#.#.#.#####.###.#.###.#.#.#.#.#.###.#
#.#.#.#.#...#.....#.#.#.#...#.......#.#.....#...#.....#...#...#...#.#.#.#...#...#
#.#.#.#.#.#######.#.#.#.#.###.#######.#.#############.###.#.#.#.#.###.#.#.#####.#
#...#.#.#.#.#.....#.#.#.#.#.......#.#...#.......#.....#.....#...#.#...#...#...#.#
###.#.#.###.#.###.###.#.#.###.###.#.#.#####.###.#####.#.###.###.#####.###.###.#.#
#.......#.....#...#...#.#.#...#.....#...#.....#.........#.....#.#.......#...#...
###############################################################################.