..#############################
......#.....#.......#.........#
#.#.#.#.#.#.###.###.###.#.#####
#.#.#...#.#.#.#.#.....#.#.....#
#.###.#.#####.#.###.#.#.#.#####
#...#.#...........#.#...#.#.#.#
#######.#.#.###.###.#.#.###.#.#
#.#...#.#.#...#.#...#.#.....#.#
#.###.###########.###########.#
#.....#.#...#.............#...#
#.#####.#.#.#####.###.###.#.#.#
#.#.....#.#.#.....#...#...#.#.#
#.#.#####.###.#.#####.#.###.###
#.....#.......#.#.#...#...#...#
#.###.#.#####.#.#.#########.#.#
#.#.#...#.#.#.#.....#.......#.#
#.#.#####.#.#####.#.#.#.#.###.#
#.......#.........#.#.#.#...#.#
#.###.#############.#.###.#.#.#
#...#.......#.........#...#.#.
#############################.