..###################
....#.......#.......#
#.#.#.###.#.###.###.#
#.#.....#.#.#.....#.#
#.#.#######.#.#.#.###
#.#.#.....#...#.#...#
#####.#########.#####
#.......#...#.#.#...#
#.#.#####.#.#.#.###.#
#.#.#.#.#.#.........#
#.###.#.###.#########
#.#...#...#.#.......#
#.#.###.#.#.#.#######
#.....#.#...#.#.#.#.#
#.#######.#.#.#.#.#.#
#...#.#...#.#...#...#
#.#.#.#.#.#.#.#####.#
#.#.#...#.#.........#
#.###.#######.###.#.#
#.........#.....#.#.
###################.