..###################
........#...#.#.....#
#.###.###.#.#.#####.#
#...#...#.#.......#.#
#.#####.#####.#.###.#
#.#...#.....#.#.....#
#.###.#.#.###.#######
#.....#.#...#...#...#
#.#####.#####.#.#.###
#.....#.......#.....#
###################.#